..........
..P....PPP
.P...P.WP.
.W.P..PWP.
WWWPWW.P..
W..P......
....P.....
...WW....W
W.P....W.W
..P....P..
3 3
1 9
2 1