...PPPPPPP
.P.P......
...P......
...PWWWW..
.......W..
WWWW.WWW.W
......W..W
.....WWW.W
..........
..........
5 8
8 4
1 2
