..........
..........
..........
...P..P...
....WW....
....WW....
...P..P...
..........
..........
..........
9 5
2 6
6 1
