..........
..........
..........
WWWWWWP...
....WW....
....WW....
...P..P...
..........
..........
..........
9 5
4 9
6 1
