....W....W
W.PWW.P...
.....W...W
WWPW.....W
.........W
.......W..
..........
......W...
...W...WW.
...W.W....
1 10
6 2
2 4
