....W.....
....W.....
.W..W..W..
.W..W..W..
.W..W..W..
.W..W..W..
.W..WWWW..
.W........
.W...WW...
.W........
6 5
7 3
7 1
