WW...WW...
W.........
...P.W....
P.W.W...W.
.PW...WP.W
.....P....
....W.W..W
..PP......
.W....W.W.
.W.W.WWWW.
1 5
10 9
8 10